NO ./ressources/frog.xpm
SO ./ressources/frog.xpm
WE ./ressources/frog.xpm
EA ./ressources/frog.xpm

F 0,255,255
C 173,248,255

11111111111
10000000001
10000000001
10000000001
100001000W1
10000000001
10000000001
10000000001
11111111111