NO ./ressources/bluestone.xpm
SO ./ressources/colorstone.xpm
WE ./ressources/greystone.xpm
EA ./ressources/mossy.xpm

F 0,255,255
C 200,10,255

11111111111111
10000000000001
10000000000001
10000000000001
10000010000001
10000000000001
10000000000001
100000000000W1
11111111111111