NO ./ressources/bluestone.xpm
SO ./ressources/colorstone.xpm
WE ./ressources/greystone.xpm
EA ./ressources/mossy.xpm

F 0,255,255
C 173,248,255

11111111111
10000000001
10000000001
10000000001
10000100001
10000000001
10000000001
100000000N1
11111111111