NO ./ressources/frog.xpm
SO ./ressources/frog.xpm
WE ./ressources/frog.xpm
EA ./ressources/frog.xpm

F 1,255,255
C 173,248,255

111111111111111111111
111111111111111111111
111111111111111111111
111111111111111111111
111111111111111111111
111111111111111111111
111111111111111111111
111111111111111111111
111111111111111111111
111111111000111111111
11111111101W111111111
111111111000111111111
111111111111111111111
111111111111111111111
111111111111111111111
111111111111111111111
111111111111111111111
111111111111111111111
111111111111111111111
111111111111111111111
111111111111111111111