R 1920 1080

NO ./textures/wall_1.xpm
SO ./textures/wall_2.xpm
WE ./textures/wall_3.xpm
EA ./textures/wall_4.xpm

S ./textures/sprites/sprite.xpm
F 220,100,0
C 225,30,0

                                           111111111111111111111111111
                                          11000000000000000000000000011
                                         1100000000000000000000000000011
                                        11000000000000000000000000000001      1111111
                                        10000000000000000000000000000001      10000011
          111111111111                  10000000000000000000000000000001      100000011
         1100000000001                  100000000000000000000000000000011111111000000011
         1000000000001111111111111111111100000000000000000000000000000000000000000000001
         1000000000000000000000000000000000000000000000000000000000000011111110000000001
         1000000000001111111111100011111100000000000000N0000000000000001      1000000001
         1000000000001         10001    10000000000000000000000000000001      1100011111
         1000000000001      11110001111 10000000000000000000000000000001       11001
 111111  1111100011111      10000000001 100000000000000000000000000000011111111 1001
1100001      10001          10000000001111000000000000000000000000000011100000111001111
10000011111  10001    1111  10000000000111100000000000000000000000000111000000000000001
10000000001  10001   110011 10000000000011110000000000000000000000001110000000000000001   1111111
100000000011110001111100001 10000000000001111111111111110001111111111 100000111111110011111000001
100000000000000000000000001 110000000000001            10001          1111111      10000000000001
100000000011110001111100001  11111111111111            1000111111111111111   11111110011111000001
10000000001  10001   100001  11111111111111            1000000000000000001   1000000001   1111111
10000011111  10001   111111  10000000000001            1000000000000000001   1001111111
1100001      10001           10000000000011            1000111110000000001   1001
 111111   11110001111        1000000000011 1111111111111000111 10000000001   1001
          100000000011111111 100000000011  1100000000000000001 100000000111111001111
          100000000000000001 10000000001   1000000000000000001 111111111111000000001
          100000000011110001 10011111111   10000000000000000011111111111110000000001
          10000000001  10001 1001          10000000000000000000000000000000000000001
          11111111111  1000111001111111111110000000000000000011111111001110000000001
                       100000000000000000000000000000000000001      1001 10000000011
                       111111111111111111111000000000000000001111111100111000000011
                                           110000000000000000110000000001111111111
                                            11000000000000000110000000001
                                             1111111111111111111111111111

