NO ./ressources/bluestone.xpm
SO ./ressources/colorstone.xpm
WE ./ressources/greystone.xpm
EA ./ressources/mossy.xpm

F 25,255,255
C 10,52,255

1111111111111111111111
1000000010000000000001
1011111010111111101111
1000001000100000101001
1111111011111110111001
1S00001000000010000001
1010001011111010111001
1001111110001010101001
1000000000101010101001
1111111011101010101111
1000000010000010100001
1011111010101010111001
1010000010101010001001
1011111110101111101001
1010000010100000001001
1011111010111011101001
1000000000000010001001
1111111111111111111111