NO ./ressources/bluestone.xpm
SO ./ressources/colorstone.xpm
WE ./ressources/greystone.xpm
EA ./ressources/mossy.xpm

F 225,255,255
C 0,0,255

11111
100101
101001111
1100W1
111111
1     1
1
1
1